1111111
11100P1
1CEC001
1111111