111111111111
10010000000C
100001110100
100011E00000
111111111111