1111111111111
1E010000000C1
100P0111P1001
1P0011E0E0001
1111111111111