111111
111111
11PE11
111111
111111